0,0,0,0,0,0,0,0,0,0,0,0,0,34,35,12,13,14,31,0,0,0,0,0,0,0,0,0,0,0,0,0,0,0,0,0,0,0,0,0,0,0,0,0,0,0,0,0,0,34,35,12,13,14,31,0,0,0,0,0,0,0,0,0
8,8,8,8,8,8,8,8,8,8,8,8,8,8,8,20,21,22,8,8,8,8,8,8,8,8,8,8,8,8,8,8,8,8,8,8,8,8,8,8,8,8,8,8,8,8,8,8,8,8,8,20,21,22,8,8,8,8,8,8,8,8,8,8
16,44,16,16,16,16,16,16,16,16,16,16,16,16,16,7,16,16,16,16,16,44,16,16,16,16,16,16,16,16,16,16,16,16,16,16,16,16,16,44,16,16,16,16,16,16,16,16,16,16,16,7,16,16,16,44,16,16,16,16,16,16,16,16
24,45,24,25,24,25,24,25,24,25,24,25,24,25,24,15,24,24,24,25,24,45,24,25,24,25,24,25,24,25,24,25,24,25,24,25,24,25,24,45,24,25,24,25,24,25,24,25,24,25,24,15,24,25,24,45,24,25,24,25,24,25,24,25
32,46,32,32,32,32,32,32,32,32,32,32,32,32,32,23,32,32,32,32,32,46,32,32,32,32,32,32,32,32,32,32,32,32,32,32,32,32,32,46,32,32,32,32,32,32,32,32,32,32,32,23,32,32,32,46,32,32,32,32,32,32,32,32
5,47,5,4,5,4,5,18,19,18,19,4,5,4,28,29,30,18,19,18,19,47,5,4,5,4,5,18,19,4,17,33,5,18,19,4,5,4,5,47,18,19,18,19,18,19,5,4,5,4,28,29,30,4,5,47,49,50,51,18,19,41,40,41
48,55,39,48,48,42,6,26,27,26,27,52,53,54,36,37,38,26,27,26,27,55,48,52,53,54,39,26,27,42,43,11,6,26,27,39,52,53,54,55,26,27,26,27,26,27,48,42,6,48,36,37,38,39,48,55,9,10,48,26,27,48,48,48
56,59,58,63,56,57,56,57,56,57,59,60,61,62,63,56,57,56,56,56,56,57,59,60,61,62,58,63,56,57,56,57,56,57,59,58,60,61,62,63,56,57,56,57,57,56,57,57,56,57,56,57,59,58,63,57,56,57,56,57,56,57,56,57

