0,1,2,0,1,2,0,1,2,0,1,2,0,1,2,0,1,2,0,1,2,0,1,2,0,1,2,0,1,2,0,1,2,0,1,2,0,1,2,0,1,2,0,1,2,0,1,2
39,39,39,8,9,10,39,39,39,39,8,9,10,39,39,39,39,39,39,39,39,39,39,39,39,39,39,39,39,39,39,39,8,9,10,39,39,39,8,9,10,39,39,39,39,39,39,39
47,19,47,16,17,18,47,47,47,47,16,17,18,47,47,47,47,47,47,47,47,19,47,20,47,20,47,20,47,19,47,47,16,17,18,47,47,47,16,17,18,47,47,47,47,21,22,47
24,24,24,24,35,36,37,38,44,24,26,26,24,24,35,36,37,38,24,46,24,25,25,28,25,28,25,28,25,25,44,46,35,36,37,38,24,46,24,24,26,26,26,26,24,29,30,24
32,32,32,32,32,26,26,45,32,26,42,43,26,45,32,26,26,32,32,32,25,26,33,33,26,33,26,33,33,26,25,32,32,26,26,32,32,45,32,26,42,43,40,41,26,32,32,32
25,25,25,25,25,34,27,25,25,25,40,41,25,25,25,34,27,25,25,25,25,26,25,25,15,25,15,25,25,26,25,25,25,34,27,25,25,25,25,15,40,41,42,43,15,25,25,25
33,33,33,33,33,26,26,33,33,33,42,43,33,33,33,26,26,33,33,33,33,26,33,33,23,33,23,33,33,26,33,33,33,26,26,33,33,33,33,23,42,43,42,43,23,33,33,33
31,31,31,31,31,31,31,31,31,31,31,31,31,31,31,31,31,31,31,31,31,31,31,31,31,31,31,31,31,31,31,31,31,31,31,31,31,31,31,31,31,31,31,31,31,31,31,31

