2,2,2,1,2,3,2,3,2,2,2,1,2,4,3,2,2,2,1,2,3,4,2,2,2,1,2,2,4,3,2,2,1,2,3,4,2,2,2,1,2,2,2,3,4,2,1,2,2,2,3,2,2,1,4,3,2,3,2,2,1,2,2,2
5,5,5,5,5,5,5,5,5,5,5,5,5,5,5,5,5,5,5,5,5,5,5,5,5,5,5,5,5,5,8,9,5,5,5,5,5,5,5,8,9,5,5,5,5,5,5,5,5,5,5,5,5,5,5,5,8,9,5,5,5,5,5,8
7,7,14,7,33,34,17,20,20,20,20,20,20,7,14,7,7,7,7,51,50,55,55,55,55,55,55,7,33,34,10,11,25,25,25,25,25,25,25,10,11,7,7,14,7,7,7,7,7,7,7,7,7,7,7,7,10,11,7,7,7,7,7,10
15,6,25,26,33,34,18,21,59,21,21,59,21,6,15,6,25,26,6,48,49,57,57,57,57,57,57,58,33,34,10,11,26,25,26,25,26,25,26,10,11,42,43,15,6,25,26,6,15,6,26,25,26,25,6,15,10,11,27,27,27,27,27,10
16,7,26,25,33,34,18,22,22,22,22,22,22,7,16,7,26,25,7,48,49,52,56,52,56,52,56,58,33,34,10,11,25,26,27,26,27,26,25,10,11,42,43,16,7,26,25,7,16,7,25,26,25,26,7,16,10,11,27,27,27,27,27,10
7,6,40,6,33,34,18,23,23,23,60,23,23,6,42,41,41,41,43,45,47,62,62,54,62,62,54,58,33,34,10,11,26,25,26,25,26,25,26,10,11,42,43,7,40,7,7,40,7,6,7,7,7,7,6,7,10,11,27,27,27,27,27,10
25,25,39,25,35,36,19,24,24,24,63,24,24,25,25,25,25,25,25,44,46,61,61,53,61,61,53,25,35,36,10,11,25,25,25,25,25,25,25,10,11,25,25,25,39,25,25,39,25,25,25,25,25,25,25,25,10,11,26,25,26,25,26,10
0,37,38,0,0,28,0,0,0,0,0,0,0,28,29,30,0,0,0,0,0,0,0,0,0,0,0,0,0,0,12,13,0,0,0,0,0,0,0,12,13,0,0,37,38,28,37,38,0,28,0,0,0,28,0,0,12,13,0,0,0,0,0,12

