3,4,2,1,2,2,3,4,3,2,2,1,2,2,3,2,2,2,1,2,3,4,2,2,2,1,2,2,2,3,4,2,1,2,2,2,2,2,2,1,3,4,2,2,2,2,1,2
5,5,5,5,5,8,9,5,5,5,5,5,5,5,5,5,5,5,5,5,5,5,5,5,5,5,5,5,5,5,5,8,9,5,5,5,5,5,5,5,5,5,5,5,5,5,5,5
25,25,25,25,25,10,11,7,7,7,7,7,14,7,7,7,7,7,7,14,17,20,20,20,20,20,20,20,7,14,7,10,11,7,7,7,7,7,7,7,14,7,7,7,7,7,7,7
26,25,26,25,26,10,11,6,15,6,25,26,6,15,6,25,26,25,26,6,18,21,59,21,21,21,21,21,58,15,6,10,11,42,43,6,15,6,25,26,6,15,6,25,26,25,26,25
25,26,25,26,25,10,11,7,16,7,26,25,7,16,7,26,25,26,25,7,18,22,22,22,22,22,22,22,7,16,7,10,11,42,43,7,16,7,26,25,7,16,7,26,25,26,25,26
31,31,31,25,26,10,11,6,7,6,7,7,40,7,6,7,7,7,7,6,18,23,23,23,23,60,23,23,58,7,6,10,11,42,43,40,7,40,7,7,6,7,6,7,7,7,7,7
32,32,32,25,25,10,11,25,25,25,25,25,39,25,25,25,25,25,25,25,19,24,24,24,24,63,24,24,25,25,25,10,11,25,25,39,25,39,25,25,25,25,25,25,25,25,25,25
0,0,0,0,0,12,13,0,0,28,0,37,38,0,28,29,30,0,0,28,0,0,0,0,0,0,0,0,0,28,0,12,13,0,37,38,37,38,0,28,0,0,29,30,0,28,0,0

