3,4,3,4,3,4,33,4,3,4,3,4,3,33,3,4
5,34,31,5,5,5,35,32,5,46,5,5,34,31,32,5
23,24,30,6,23,24,36,6,6,36,23,24,6,30,23,24
22,22,22,22,22,22,38,28,29,37,22,22,47,22,22,22
23,24,47,22,23,24,36,26,27,36,23,24,22,22,23,24
11,10,11,10,11,12,39,25,44,39,7,8,9,8,9,8
14,13,14,13,14,15,16,17,45,18,19,20,21,20,42,43
0,1,0,0,2,0,0,1,0,2,0,0,1,0,40,41

