0,1,2,0,1,2,0,1,2,0,1,2,0,1,2,0,1,2,0,1,2,0,1,2,0,1,2,0,1,2,0,1,2,0,1,2,0,1,2,0,1,2,0,1,2,0,1,2,0,1,2,0,1,2,0,1,2,0,1,2,0,1,2,0
39,39,39,39,39,39,39,39,39,39,39,39,39,8,9,10,39,39,39,39,39,39,39,39,39,39,39,39,39,39,39,39,39,39,39,39,39,39,39,39,39,39,39,39,39,39,39,39,39,39,39,39,8,9,10,39,39,25,8,9,10,39,25,39
47,21,22,47,47,19,47,47,47,47,19,47,47,16,17,18,47,47,47,47,47,47,19,26,26,19,47,3,4,4,5,4,4,4,4,4,5,4,6,26,19,26,26,19,26,47,47,47,47,19,47,47,16,17,18,26,19,33,16,17,18,47,33,19
24,29,30,46,26,26,26,26,26,26,24,26,26,24,24,24,44,35,36,37,38,44,24,26,26,24,24,11,12,12,13,12,12,12,12,12,13,12,14,26,19,20,20,19,26,35,36,37,38,24,24,44,46,24,24,26,19,26,35,36,37,38,26,19
32,32,32,26,40,41,42,43,40,41,26,42,43,26,32,32,32,32,26,26,32,32,32,26,26,32,32,32,7,32,32,32,7,32,32,32,7,32,32,26,19,28,28,19,26,32,26,26,32,32,45,45,32,32,45,32,25,23,26,20,20,26,23,33
25,25,25,15,40,41,40,41,42,43,15,40,41,15,25,25,25,25,34,27,25,25,26,26,26,26,25,25,15,42,41,25,15,25,42,43,15,25,25,25,26,40,43,26,25,25,34,27,25,25,25,25,25,25,25,25,25,15,26,28,28,26,15,25
33,33,33,23,42,43,42,43,40,41,23,42,43,23,33,33,33,33,26,26,33,33,34,26,26,27,33,33,23,40,43,33,23,33,42,43,23,33,33,33,34,40,41,27,33,33,26,26,33,33,33,33,33,33,33,33,33,23,40,43,40,41,23,33
31,31,31,31,31,31,31,31,31,31,31,31,31,31,31,31,31,31,31,31,31,31,31,31,31,31,31,31,31,31,31,31,31,31,31,31,31,31,31,31,31,31,31,31,31,31,31,31,31,31,31,31,31,31,31,31,31,31,31,31,31,31,31,31

