0,0,0,0,0,0,0,0,0,0,0,0,0,0,0,0,0,0,0,0,0,0,0,0,0,0,0,0,0,0,0,0,0,0,0,0,0,0,0,0,0,0,0,0,0,0,0,0
8,8,8,8,8,8,8,8,8,8,8,8,8,8,8,8,8,8,8,8,8,8,8,8,8,8,8,8,8,8,8,8,8,8,8,8,8,8,8,8,8,8,8,8,8,8,8,8
16,16,16,16,16,16,16,16,16,16,16,16,16,44,16,16,16,16,16,16,16,16,16,16,16,44,16,16,16,16,16,16,16,16,16,16,16,44,16,16,16,16,16,16,16,16,16,44
24,25,24,25,24,25,24,25,24,25,24,25,24,45,24,25,24,25,24,25,24,25,24,25,24,45,24,25,24,25,24,25,24,25,24,25,24,45,24,25,24,25,24,25,24,25,24,45
32,32,32,32,32,32,32,32,32,32,32,32,32,46,32,32,32,32,32,32,32,32,32,32,32,46,32,32,32,32,32,32,32,32,32,32,32,46,32,32,32,32,32,32,32,32,32,46
40,41,40,41,40,41,18,19,1,2,3,4,5,47,5,18,19,18,19,4,5,4,5,4,5,47,5,18,19,18,19,4,5,18,19,18,19,47,5,4,5,4,5,18,19,18,19,47
48,48,48,48,48,48,26,27,9,10,39,48,48,55,48,26,27,26,27,48,39,52,53,54,48,55,48,26,27,26,27,42,6,26,27,26,27,55,52,53,54,39,48,26,27,26,27,55
56,57,56,57,56,57,56,57,56,59,58,63,56,57,56,56,56,57,56,59,58,60,61,62,63,57,56,57,56,57,56,57,56,57,56,57,56,59,60,61,62,58,63,57,56,56,56,56

